+---+---+---+---+---+
s   |               |
+   +   +   +---+---+
|   |   |           |
+   +---+---+---+   +
|   |               |
+   +   +---+---+   +
|       |           |
+---+---+   +---+---+
|                   e   
+---+---+---+---+---+
